지역명,연,월,총인구수,세대수,세대당 인구,남자 인구수,여자 인구수
강원도,2020,1,1540540,720119,2.14,774866,765674
강원도,2020,2,1539521,721003,2.14,774358,765163
강원도,2020,3,1538577,721794,2.13,773983,764594
강원도,2020,4,1537780,722573,2.13,773468,764312
강원도,2020,5,1538639,724966,2.12,773923,764716
강원도,2020,6,1539282,726980,2.12,774325,764957
강원도,2020,7,1540094,728771,2.11,774913,765181
강원도,2020,8,1540689,730504,2.11,775113,765576
강원도,2020,9,1541104,732005,2.11,775324,765780
강원도,2020,10,1541836,733436,2.1,775679,766157
강원도,2020,11,1542374,734819,2.1,776079,766295
강원도,2020,12,1542840,736301,2.1,776505,766335
강원도,2021,1,1541696,736825,2.09,775727,765969
강원도,2021,2,1540875,737787,2.09,775186,765689
강원도,2021,3,1536399,735644,2.09,773248,763151
강원도,2021,4,1536175,736749,2.09,773037,763138
강원도,2021,5,1535491,736980,2.08,772893,762598
강원도,2021,6,1535530,738068,2.08,772949,762581
강원도,2021,7,1536140,739290,2.08,773232,762908
강원도,2021,8,1536270,740341,2.08,773260,763010
강원도,2021,9,1536765,742196,2.07,773495,763270
강원도,2021,10,1537717,743798,2.07,774008,763709
강원도,2021,11,1538273,745060,2.06,774232,764041
강원도,2021,12,1538492,746220,2.06,774332,764160
강원도,2022,1,1538660,747023,2.06,774315,764345
강원도,2022,2,1539051,748626,2.06,774543,764508
강원도,2022,3,1539036,750531,2.05,774522,764514
강원도,2022,4,1539038,751554,2.05,774562,764476
강원도,2022,5,1539005,752649,2.04,774458,764547
강원도,2022,6,1539064,753336,2.04,774405,764659
강원도,2022,7,1539178,754257,2.04,774387,764791
강원도,2022,8,1538801,755162,2.04,774193,764608
강원도,2022,9,1537396,754682,2.04,773576,763820
강원도,2022,10,1537339,755184,2.04,773491,763848
강원도,2022,11,1536863,755157,2.04,773182,763681
강원도,2022,12,1536498,755481,2.03,772947,763551
강원도,2023,1,1535373,755474,2.03,772297,763076
강원도,2023,2,1534067,756314,2.03,771758,762309
강원도,2023,3,1533719,758123,2.02,771574,762145
강원도,2023,4,1533356,758699,2.02,771382,761974
강원도,2023,5,1533081,759593,2.02,771322,761759
강원도,2023,6,1532617,759954,2.02,771147,761470
강원도,2023,7,1532050,760211,2.02,770730,761320
강원도,2023,8,1531390,760627,2.01,770401,760989
강원도,2023,9,1530712,760903,2.01,770130,760582
강원도,2023,10,1529500,760656,2.01,769433,760067
강원도,2023,11,1528635,760636,2.01,768910,759725
강원도,2023,12,1527807,760635,2.01,768449,759358
강원도,2024,1,1526243,760361,2.01,767496,758747
강원도,2024,2,1524624,760929,2.0,766727,757897
강원도,2024,3,1524198,763008,2.0,766562,757636
강원도,2024,4,1523661,763568,2.0,766338,757323
강원도,2024,5,1522952,763999,1.99,765997,756955
강원도,2024,6,1522542,764385,1.99,765760,756782
강원도,2024,7,1521877,764811,1.99,765321,756556
경기도,2020,1,13250368,5480444,2.42,6665310,6585058
경기도,2020,2,13265377,5497087,2.41,6672706,6592671
경기도,2020,3,13288975,5514938,2.41,6684759,6604216
경기도,2020,4,13311254,5529263,2.41,6696531,6614723
경기도,2020,5,13324041,5547190,2.4,6703603,6620438
경기도,2020,6,13338020,5566078,2.4,6711047,6626973
경기도,2020,7,13351891,5584110,2.39,6717812,6634079
경기도,2020,8,13370714,5605611,2.39,6727226,6643488
경기도,2020,9,13388485,5626369,2.38,6736077,6652408
경기도,2020,10,13400615,5641978,2.38,6741849,6658766
경기도,2020,11,13413459,5658580,2.37,6748061,6665398
경기도,2020,12,13427014,5676401,2.37,6754469,6672545
경기도,2021,1,13449499,5694934,2.36,6765862,6683637
경기도,2021,2,13471758,5717252,2.36,6777066,6694692
경기도,2021,3,13465837,5719333,2.35,6776866,6688971
경기도,2021,4,13479798,5735887,2.35,6784466,6695332
경기도,2021,5,13488910,5749175,2.35,6789327,6699583
경기도,2021,6,13500688,5763227,2.34,6795088,6705600
경기도,2021,7,13512867,5776653,2.34,6801008,6711859
경기도,2021,8,13530519,5793437,2.34,6810105,6720414
경기도,2021,9,13542284,5809524,2.33,6816449,6725835
경기도,2021,10,13549577,5820524,2.33,6820025,6729552
경기도,2021,11,13557973,5831464,2.32,6823931,6734042
경기도,2021,12,13565450,5841995,2.32,6827298,6738152
경기도,2022,1,13571450,5850373,2.32,6830317,6741133
경기도,2022,2,13574369,5861240,2.32,6831902,6742467
경기도,2022,3,13575936,5871380,2.31,6832830,6743106
경기도,2022,4,13577808,5880097,2.31,6833859,6743949
경기도,2022,5,13581496,5890145,2.31,6835968,6745528
경기도,2022,6,13585967,5898050,2.3,6838396,6747571
경기도,2022,7,13589362,5904582,2.3,6840138,6749224
경기도,2022,8,13590056,5910963,2.3,6840757,6749299
경기도,2022,9,13574353,5902827,2.3,6832856,6741497
경기도,2022,10,13579508,5908615,2.3,6835151,6744357
경기도,2022,11,13583238,5909700,2.3,6836309,6746929
경기도,2022,12,13589432,5913694,2.3,6839276,6750156
경기도,2023,1,13596091,5918630,2.3,6842226,6753865
경기도,2023,2,13600800,5927894,2.29,6844167,6756633
경기도,2023,3,13603546,5936411,2.29,6845505,6758041
경기도,2023,4,13607919,5942067,2.29,6847848,6760071
경기도,2023,5,13612597,5948920,2.29,6850133,6762464
경기도,2023,6,13618969,5956358,2.29,6852980,6765989
경기도,2023,7,13623055,5962224,2.28,6854747,6768308
경기도,2023,8,13624964,5965990,2.28,6855409,6769555
경기도,2023,9,13626339,5969573,2.28,6855626,6770713
경기도,2023,10,13627840,5971803,2.28,6855616,6772224
경기도,2023,11,13628135,5974055,2.28,6855041,6773094
경기도,2023,12,13630821,5978724,2.28,6855895,6774926
경기도,2024,1,13635250,5984576,2.28,6857867,6777383
경기도,2024,2,13639616,5994965,2.28,6859811,6779805
경기도,2024,3,13642451,6003993,2.27,6860823,6781628
경기도,2024,4,13648156,6010717,2.27,6863252,6784904
경기도,2024,5,13654710,6018450,2.27,6866117,6788593
경기도,2024,6,13661438,6025219,2.27,6868886,6792552
경기도,2024,7,13669469,6033443,2.27,6872643,6796826
경상남도,2020,1,3361344,1453042,2.31,1691504,1669840
경상남도,2020,2,3358828,1455655,2.31,1690600,1668228
경상남도,2020,3,3355341,1458567,2.3,1689137,1666204
경상남도,2020,4,3353380,1461207,2.29,1688178,1665202
경상남도,2020,5,3351347,1465556,2.29,1687289,1664058
경상남도,2020,6,3349454,1468692,2.28,1686331,1663123
경상남도,2020,7,3347637,1470937,2.28,1685427,1662210
경상남도,2020,8,3345169,1473746,2.27,1684134,1661035
경상남도,2020,9,3343770,1476628,2.26,1683263,1660507
경상남도,2020,10,3342831,1478602,2.26,1682733,1660098
경상남도,2020,11,3341063,1481086,2.26,1681719,1659344
경상남도,2020,12,3340216,1484601,2.25,1681423,1658793
경상남도,2021,1,3338396,1487083,2.24,1680383,1658013
경상남도,2021,2,3336045,1490502,2.24,1679295,1656750
경상남도,2021,3,3330463,1490880,2.23,1677021,1653442
경상남도,2021,4,3329623,1493396,2.23,1676550,1653073
경상남도,2021,5,3327298,1494518,2.23,1675389,1651909
경상남도,2021,6,3325840,1496137,2.22,1674612,1651228
경상남도,2021,7,3324735,1498081,2.22,1674003,1650732
경상남도,2021,8,3322373,1499638,2.22,1672737,1649636
경상남도,2021,9,3319271,1501655,2.21,1671042,1648229
경상남도,2021,10,3318161,1503397,2.21,1670394,1647767
경상남도,2021,11,3316365,1504605,2.2,1669512,1646853
경상남도,2021,12,3314183,1505971,2.2,1668338,1645845
경상남도,2022,1,3311438,1506797,2.2,1666968,1644470
경상남도,2022,2,3307005,1508852,2.19,1664907,1642098
경상남도,2022,3,3303274,1510929,2.19,1663146,1640128
경상남도,2022,4,3300692,1512847,2.18,1661866,1638826
경상남도,2022,5,3298016,1514453,2.18,1660600,1637416
경상남도,2022,6,3295615,1515190,2.18,1659245,1636370
경상남도,2022,7,3293709,1515978,2.17,1658198,1635511
경상남도,2022,8,3290991,1516883,2.17,1656746,1634245
경상남도,2022,9,3286470,1515985,2.17,1654622,1631848
경상남도,2022,10,3284495,1516472,2.17,1653654,1630841
경상남도,2022,11,3282849,1516647,2.16,1652807,1630042
경상남도,2022,12,3280493,1516930,2.16,1651675,1628818
경상남도,2023,1,3277672,1517009,2.16,1650300,1627372
경상남도,2023,2,3272381,1518385,2.16,1647690,1624691
경상남도,2023,3,3269228,1520120,2.15,1646280,1622948
경상남도,2023,4,3267369,1521214,2.15,1645335,1622034
경상남도,2023,5,3265018,1522410,2.14,1644124,1620894
경상남도,2023,6,3263251,1523314,2.14,1643148,1620103
경상남도,2023,7,3261361,1523806,2.14,1642061,1619300
경상남도,2023,8,3258309,1524252,2.14,1640552,1617757
경상남도,2023,9,3257009,1524861,2.14,1639932,1617077
경상남도,2023,10,3255239,1524850,2.13,1638978,1616261
경상남도,2023,11,3253619,1525337,2.13,1638128,1615491
경상남도,2023,12,3251158,1525502,2.13,1636987,1614171
경상남도,2024,1,3248703,1525692,2.13,1636010,1612693
경상남도,2024,2,3244232,1526864,2.12,1634026,1610206
경상남도,2024,3,3241374,1529476,2.12,1632685,1608689
경상남도,2024,4,3239224,1530698,2.12,1631669,1607555
경상남도,2024,5,3237140,1531758,2.11,1630664,1606476
경상남도,2024,6,3236224,1532659,2.11,1630324,1605900
경상남도,2024,7,3235125,1534273,2.11,1629977,1605148
경상북도,2020,1,2662508,1228044,2.17,1340346,1322162
경상북도,2020,2,2658956,1229265,2.16,1338907,1320049
경상북도,2020,3,2653418,1231572,2.15,1336289,1317129
경상북도,2020,4,2651054,1235801,2.15,1334981,1316073
경상북도,2020,5,2648760,1239069,2.14,1333815,1314945
경상북도,2020,6,2646493,1241310,2.13,1332780,1313713
경상북도,2020,7,2644001,1242701,2.13,1331461,1312540
경상북도,2020,8,2640932,1244551,2.12,1329919,1311013
경상북도,2020,9,2640003,1246952,2.12,1329408,1310595
경상북도,2020,10,2639763,1249009,2.11,1329257,1310506
경상북도,2020,11,2639245,1251445,2.11,1328939,1310306
경상북도,2020,12,2639422,1254662,2.1,1329211,1310211
경상북도,2021,1,2637639,1256416,2.1,1328384,1309255
경상북도,2021,2,2636747,1259684,2.09,1328167,1308580
경상북도,2021,3,2635563,1262718,2.09,1327990,1307573
경상북도,2021,4,2635896,1265410,2.08,1328240,1307656
경상북도,2021,5,2633592,1265179,2.08,1327307,1306285
경상북도,2021,6,2632401,1266588,2.08,1326844,1305557
경상북도,2021,7,2631649,1268267,2.07,1326218,1305431
경상북도,2021,8,2630254,1269770,2.07,1325354,1304900
경상북도,2021,9,2628344,1271864,2.07,1324322,1304022
경상북도,2021,10,2627925,1273579,2.06,1324128,1303797
경상북도,2021,11,2627468,1275275,2.06,1324021,1303447
경상북도,2021,12,2626609,1276846,2.06,1323661,1302948
경상북도,2022,1,2624310,1277295,2.05,1322509,1301801
경상북도,2022,2,2622026,1279337,2.05,1321638,1300388
경상북도,2022,3,2619641,1281587,2.04,1320888,1298753
경상북도,2022,4,2617552,1282737,2.04,1320018,1297534
경상북도,2022,5,2616177,1284046,2.04,1319332,1296845
경상북도,2022,6,2613963,1284663,2.03,1318198,1295765
경상북도,2022,7,2612016,1285289,2.03,1317139,1294877
경상북도,2022,8,2609356,1286286,2.03,1315815,1293541
경상북도,2022,9,2605066,1285019,2.03,1313983,1291083
경상북도,2022,10,2603389,1285483,2.03,1313237,1290152
경상북도,2022,11,2602052,1286170,2.02,1312637,1289415
경상북도,2022,12,2600492,1286873,2.02,1311881,1288611
경상북도,2023,1,2597527,1286840,2.02,1310583,1286944
경상북도,2023,2,2594399,1288685,2.01,1309417,1284982
경상북도,2023,3,2593210,1291726,2.01,1309056,1284154
경상북도,2023,4,2592205,1292951,2.0,1308840,1283365
경상북도,2023,5,2590726,1294627,2.0,1308195,1282531
경상북도,2023,6,2588860,1295243,2.0,1307284,1281576
경상북도,2023,7,2564065,1282140,2.0,1294579,1269486
경상북도,2023,8,2561623,1282304,2.0,1293508,1268115
경상북도,2023,9,2559924,1282575,2.0,1292868,1267056
경상북도,2023,10,2558085,1282624,1.99,1292163,1265922
경상북도,2023,11,2556262,1282673,1.99,1291263,1264999
경상북도,2023,12,2554324,1282500,1.99,1290298,1264026
경상북도,2024,1,2551370,1281979,1.99,1288999,1262371
경상북도,2024,2,2548440,1283187,1.99,1287853,1260587
경상북도,2024,3,2546960,1286272,1.98,1287412,1259548
경상북도,2024,4,2546120,1288344,1.98,1287249,1258871
경상북도,2024,5,2545421,1290433,1.97,1286984,1258437
경상북도,2024,6,2544174,1291330,1.97,1286551,1257623
경상북도,2024,7,2542072,1291611,1.97,1285674,1256398
광주광역시,2020,1,1456688,617379,2.36,720931,735757
광주광역시,2020,2,1456121,618503,2.35,720686,735435
광주광역시,2020,3,1455705,620050,2.35,720460,735245
광주광역시,2020,4,1456096,622374,2.34,720536,735560
광주광역시,2020,5,1455533,624687,2.33,720300,735233
광주광역시,2020,6,1455048,626386,2.32,720060,734988
광주광역시,2020,7,1454709,627676,2.32,719860,734849
광주광역시,2020,8,1454154,629054,2.31,719601,734553
광주광역시,2020,9,1453952,630695,2.31,719445,734507
광주광역시,2020,10,1452994,631269,2.3,718912,734082
광주광역시,2020,11,1451993,632264,2.3,718370,733623
광주광역시,2020,12,1450062,633582,2.29,717348,732714
광주광역시,2021,1,1449115,634859,2.28,716929,732186
광주광역시,2021,2,1447953,635999,2.28,716331,731622
광주광역시,2021,3,1445473,636160,2.27,715226,730247
광주광역시,2021,4,1444787,637169,2.27,714834,729953
광주광역시,2021,5,1443154,637364,2.26,714101,729053
광주광역시,2021,6,1442647,638270,2.26,713793,728854
광주광역시,2021,7,1442482,639333,2.26,713626,728856
광주광역시,2021,8,1441970,640836,2.25,713286,728684
광주광역시,2021,9,1442827,642726,2.24,713666,729161
광주광역시,2021,10,1442454,643841,2.24,713483,728971
광주광역시,2021,11,1442138,644972,2.24,713292,728846
광주광역시,2021,12,1441611,645712,2.23,713015,728596
광주광역시,2022,1,1441636,646429,2.23,713037,728599
광주광역시,2022,2,1440032,647419,2.22,712199,727833
광주광역시,2022,3,1438463,648252,2.22,711289,727174
광주광역시,2022,4,1436916,648653,2.22,710524,726392
광주광역시,2022,5,1436012,649454,2.21,710062,725950
광주광역시,2022,6,1435378,650131,2.21,709685,725693
광주광역시,2022,7,1434703,650708,2.2,709305,725398
광주광역시,2022,8,1434397,652050,2.2,709090,725307
광주광역시,2022,9,1432856,652047,2.2,708248,724608
광주광역시,2022,10,1432651,652598,2.2,708119,724532
광주광역시,2022,11,1432049,652435,2.19,707815,724234
광주광역시,2022,12,1431050,652355,2.19,707299,723751
광주광역시,2023,1,1429816,652374,2.19,706724,723092
광주광역시,2023,2,1428927,653209,2.19,706167,722760
광주광역시,2023,3,1427508,653806,2.18,705471,722037
광주광역시,2023,4,1426625,654192,2.18,704974,721651
광주광역시,2023,5,1425739,654682,2.18,704489,721250
광주광역시,2023,6,1424818,655025,2.18,703887,720931
광주광역시,2023,7,1424305,655435,2.17,703548,720757
광주광역시,2023,8,1423810,656055,2.17,703131,720679
광주광역시,2023,9,1422999,656061,2.17,702748,720251
광주광역시,2023,10,1421760,655675,2.17,702121,719639
광주광역시,2023,11,1420822,655552,2.17,701645,719177
광주광역시,2023,12,1419237,655433,2.17,700896,718341
광주광역시,2024,1,1418241,655359,2.16,700377,717864
광주광역시,2024,2,1417031,656017,2.16,699715,717316
광주광역시,2024,3,1415774,656755,2.16,699084,716690
광주광역시,2024,4,1414862,656984,2.15,698628,716234
광주광역시,2024,5,1414254,657520,2.15,698255,715999
광주광역시,2024,6,1413606,657693,2.15,697904,715702
광주광역시,2024,7,1412986,657959,2.15,697557,715429
대구광역시,2020,1,2436488,1032478,2.36,1204387,1232101
대구광역시,2020,2,2432883,1033349,2.35,1202364,1230519
대구광역시,2020,3,2433568,1037956,2.34,1202273,1231295
대구광역시,2020,4,2431523,1041932,2.33,1200899,1230624
대구광역시,2020,5,2429059,1044412,2.33,1199504,1229555
대구광역시,2020,6,2427954,1046585,2.32,1198815,1229139
대구광역시,2020,7,2428022,1048735,2.32,1198621,1229401
대구광역시,2020,8,2428228,1050852,2.31,1198662,1229566
대구광역시,2020,9,2426849,1052646,2.31,1197914,1228935
대구광역시,2020,10,2424171,1053168,2.3,1196446,1227725
대구광역시,2020,11,2421859,1054637,2.3,1195081,1226778
대구광역시,2020,12,2418346,1056627,2.29,1193109,1225237
대구광역시,2021,1,2415813,1058117,2.28,1191656,1224157
대구광역시,2021,2,2413191,1059963,2.28,1190244,1222947
대구광역시,2021,3,2408875,1060866,2.27,1188070,1220805
대구광역시,2021,4,2406296,1061829,2.27,1186663,1219633
대구광역시,2021,5,2402940,1061872,2.26,1184977,1217963
대구광역시,2021,6,2397646,1059826,2.26,1182380,1215266
대구광역시,2021,7,2395749,1060394,2.26,1181351,1214398
대구광역시,2021,8,2393626,1061159,2.26,1180223,1213403
대구광역시,2021,9,2392787,1062536,2.25,1179640,1213147
대구광역시,2021,10,2390721,1062993,2.25,1178486,1212235
대구광역시,2021,11,2388230,1063241,2.25,1177136,1211094
대구광역시,2021,12,2385412,1063893,2.24,1175632,1209780
대구광역시,2022,1,2383858,1064438,2.24,1174667,1209191
대구광역시,2022,2,2381095,1065477,2.23,1173039,1208056
대구광역시,2022,3,2380494,1068557,2.23,1172632,1207862
대구광역시,2022,4,2378573,1069411,2.22,1171451,1207122
대구광역시,2022,5,2376676,1070212,2.22,1170309,1206367
대구광역시,2022,6,2375306,1070705,2.22,1169571,1205735
대구광역시,2022,7,2374120,1071366,2.22,1168845,1205275
대구광역시,2022,8,2371936,1072018,2.21,1167564,1204372
대구광역시,2022,9,2367735,1070482,2.21,1165326,1202409
대구광역시,2022,10,2366852,1070874,2.21,1164728,1202124
대구광역시,2022,11,2365619,1070839,2.21,1164024,1201595
대구광역시,2022,12,2363691,1070873,2.21,1162865,1200826
대구광역시,2023,1,2362880,1071182,2.21,1162217,1200663
대구광역시,2023,2,2360662,1072255,2.2,1160942,1199720
대구광역시,2023,3,2358988,1073400,2.2,1159876,1199112
대구광역시,2023,4,2357881,1074370,2.19,1159042,1198839
대구광역시,2023,5,2357032,1075529,2.19,1158397,1198635
대구광역시,2023,6,2356416,1076379,2.19,1157923,1198493
대구광역시,2023,7,2379086,1091073,2.18,1169503,1209583
대구광역시,2023,8,2378464,1091990,2.18,1169083,1209381
대구광역시,2023,9,2377801,1092536,2.18,1168679,1209122
대구광역시,2023,10,2376978,1092922,2.17,1168087,1208891
대구광역시,2023,11,2376044,1093499,2.17,1167480,1208564
대구광역시,2023,12,2374960,1094148,2.17,1166803,1208157
대구광역시,2024,1,2373844,1094529,2.17,1166110,1207734
대구광역시,2024,2,2372008,1095812,2.16,1165024,1206984
대구광역시,2024,3,2369962,1097169,2.16,1163911,1206051
대구광역시,2024,4,2368670,1098201,2.16,1163001,1205669
대구광역시,2024,5,2367803,1099465,2.15,1162463,1205340
대구광역시,2024,6,2367183,1100317,2.15,1162046,1205137
대구광역시,2024,7,2366660,1101110,2.15,1161549,1205111
대전광역시,2020,1,1474152,636203,2.32,736259,737893
대전광역시,2020,2,1473125,637726,2.31,735791,737334
대전광역시,2020,3,1471858,638921,2.3,735179,736679
대전광역시,2020,4,1471650,640500,2.3,734902,736748
대전광역시,2020,5,1471915,643220,2.29,734940,736975
대전광역시,2020,6,1471040,644764,2.28,734441,736599
대전광역시,2020,7,1470225,646211,2.28,734008,736217
대전광역시,2020,8,1469431,647818,2.27,733547,735884
대전광역시,2020,9,1469099,649552,2.26,733356,735743
대전광역시,2020,10,1467556,650636,2.26,732552,735004
대전광역시,2020,11,1465893,651488,2.25,731701,734192
대전광역시,2020,12,1463882,652783,2.24,730699,733183
대전광역시,2021,1,1463291,654078,2.24,730396,732895
대전광역시,2021,2,1462064,655842,2.23,729663,732401
대전광역시,2021,3,1458463,655196,2.23,728075,730388
대전광역시,2021,4,1457619,656007,2.22,727522,730097
대전광역시,2021,5,1457161,657087,2.22,727279,729882
대전광역시,2021,6,1456107,657781,2.21,726666,729441
대전광역시,2021,7,1455300,658831,2.21,726281,729019
대전광역시,2021,8,1454679,659978,2.2,725956,728723
대전광역시,2021,9,1455058,661948,2.2,726142,728916
대전광역시,2021,10,1454228,662615,2.19,725742,728486
대전광역시,2021,11,1453675,663621,2.19,725406,728269
대전광역시,2021,12,1452251,664417,2.19,724626,727625
대전광역시,2022,1,1451272,664804,2.18,724026,727246
대전광역시,2022,2,1450862,666643,2.18,723812,727050
대전광역시,2022,3,1450057,667934,2.17,723361,726696
대전광역시,2022,4,1449360,668599,2.17,723063,726297
대전광역시,2022,5,1448933,669589,2.16,722840,726093
대전광역시,2022,6,1448401,670279,2.16,722517,725884
대전광역시,2022,7,1448182,671127,2.16,722366,725816
대전광역시,2022,8,1448240,672491,2.15,722486,725754
대전광역시,2022,9,1446602,672212,2.15,721604,724998
대전광역시,2022,10,1446863,673098,2.15,721745,725118
대전광역시,2022,11,1446749,673163,2.15,721609,725140
대전광역시,2022,12,1446072,673429,2.15,721245,724827
대전광역시,2023,1,1445806,673759,2.15,721037,724769
대전광역시,2023,2,1445875,675760,2.14,721195,724680
대전광역시,2023,3,1445519,677326,2.13,721051,724468
대전광역시,2023,4,1445214,677706,2.13,720934,724280
대전광역시,2023,5,1445221,678666,2.13,720874,724347
대전광역시,2023,6,1445126,679151,2.13,720783,724343
대전광역시,2023,7,1444898,679611,2.13,720637,724261
대전광역시,2023,8,1444837,680337,2.12,720688,724149
대전광역시,2023,9,1444595,680653,2.12,720520,724075
대전광역시,2023,10,1443965,680363,2.12,720207,723758
대전광역시,2023,11,1443106,680226,2.12,719805,723301
대전광역시,2023,12,1442216,680261,2.12,719292,722924
대전광역시,2024,1,1441562,680459,2.12,719008,722554
대전광역시,2024,2,1441536,682238,2.11,718931,722605
대전광역시,2024,3,1441689,683954,2.11,718943,722746
대전광역시,2024,4,1441272,684540,2.11,718797,722475
대전광역시,2024,5,1441119,685330,2.1,718696,722423
대전광역시,2024,6,1440558,685633,2.1,718295,722263
대전광역시,2024,7,1439889,686053,2.1,717887,722002
부산광역시,2020,1,3411819,1499152,2.28,1674202,1737617
부산광역시,2020,2,3410925,1502333,2.27,1673266,1737659
부산광역시,2020,3,3409932,1505897,2.26,1672252,1737680
부산광역시,2020,4,3408347,1507504,2.26,1671199,1737148
부산광역시,2020,5,3406942,1511199,2.25,1670175,1736767
부산광역시,2020,6,3404423,1513956,2.25,1668618,1735805
부산광역시,2020,7,3402776,1517200,2.24,1667613,1735163
부산광역시,2020,8,3401072,1520321,2.24,1666462,1734610
부산광역시,2020,9,3399749,1523122,2.23,1665554,1734195
부산광역시,2020,10,3397598,1524888,2.23,1664277,1733321
부산광역시,2020,11,3395514,1527721,2.22,1663055,1732459
부산광역시,2020,12,3391946,1530431,2.22,1661000,1730946
부산광역시,2021,1,3389388,1532700,2.21,1659527,1729861
부산광역시,2021,2,3387761,1536242,2.21,1658540,1729221
부산광역시,2021,3,3372399,1527830,2.21,1651804,1720595
부산광역시,2021,4,3369704,1529794,2.2,1650252,1719452
부산광역시,2021,5,3367334,1532053,2.2,1648965,1718369
부산광역시,2021,6,3364358,1533514,2.19,1647291,1717067
부산광역시,2021,7,3361781,1535294,2.19,1645794,1715987
부산광역시,2021,8,3359527,1537395,2.19,1644378,1715149
부산광역시,2021,9,3358763,1540342,2.18,1643690,1715073
부산광역시,2021,10,3356311,1541975,2.18,1642368,1713943
부산광역시,2021,11,3353627,1543438,2.17,1640867,1712760
부산광역시,2021,12,3350380,1544663,2.17,1639044,1711336
부산광역시,2022,1,3348874,1546414,2.17,1638207,1710667
부산광역시,2022,2,3347396,1549967,2.16,1637111,1710285
부산광역시,2022,3,3343504,1551767,2.15,1634958,1708546
부산광역시,2022,4,3340214,1553032,2.15,1633170,1707044
부산광역시,2022,5,3338167,1555326,2.15,1631825,1706342
부산광역시,2022,6,3336737,1556938,2.14,1630944,1705793
부산광역시,2022,7,3334595,1558052,2.14,1629643,1704952
부산광역시,2022,8,3331444,1559462,2.14,1627821,1703623
부산광역시,2022,9,3323826,1555449,2.14,1623784,1700042
부산광역시,2022,10,3322286,1556293,2.13,1622749,1699537
부산광역시,2022,11,3320276,1555836,2.13,1621486,1698790
부산광역시,2022,12,3317812,1555867,2.13,1619915,1697897
부산광역시,2023,1,3316107,1556086,2.13,1618749,1697358
부산광역시,2023,2,3315516,1559593,2.13,1618202,1697314
부산광역시,2023,3,3313539,1561008,2.12,1616930,1696609
부산광역시,2023,4,3311402,1561666,2.12,1615593,1695809
부산광역시,2023,5,3309261,1562595,2.12,1614226,1695035
부산광역시,2023,6,3306993,1563362,2.12,1613071,1693922
부산광역시,2023,7,3305052,1564252,2.11,1611959,1693093
부산광역시,2023,8,3302740,1564900,2.11,1610738,1692002
부산광역시,2023,9,3300836,1565115,2.11,1609650,1691186
부산광역시,2023,10,3298213,1564546,2.11,1608156,1690057
부산광역시,2023,11,3295496,1564199,2.11,1606680,1688816
부산광역시,2023,12,3293362,1564588,2.1,1605431,1687931
부산광역시,2024,1,3290964,1564763,2.1,1603859,1687105
부산광역시,2024,2,3289401,1567409,2.1,1602971,1686430
부산광역시,2024,3,3287292,1569084,2.1,1601773,1685519
부산광역시,2024,4,3284947,1569293,2.09,1600234,1684713
부산광역시,2024,5,3282751,1569954,2.09,1599048,1683703
부산광역시,2024,6,3280749,1570212,2.09,1597869,1682880
부산광역시,2024,7,3278280,1570545,2.09,1596494,1681786
서울특별시,2020,1,9733509,4334918,2.25,4745088,4988421
서울특별시,2020,2,9736962,4345877,2.24,4745133,4991829
서울특별시,2020,3,9733655,4354006,2.24,4742217,4991438
서울특별시,2020,4,9726787,4361645,2.23,4737843,4988944
서울특별시,2020,5,9724496,4373610,2.22,4735431,4989065
서울특별시,2020,6,9720846,4384076,2.22,4732275,4988571
서울특별시,2020,7,9715429,4391545,2.21,4728872,4986557
서울특별시,2020,8,9708247,4400154,2.21,4724585,4983662
서울특별시,2020,9,9699232,4405833,2.2,4719170,4980062
서울특별시,2020,10,9689159,4408498,2.2,4713716,4975443
서울특별시,2020,11,9679771,4412343,2.19,4708321,4971450
서울특별시,2020,12,9668465,4417954,2.19,4701723,4966742
서울특별시,2021,1,9657969,4421022,2.18,4695999,4961970
서울특별시,2021,2,9648606,4427814,2.18,4690282,4958324
서울특별시,2021,3,9598484,4400403,2.18,4667524,4930960
서울특별시,2021,4,9588711,4403263,2.18,4661711,4927000
서울특별시,2021,5,9575355,4403381,2.17,4654720,4920635
서울특별시,2021,6,9565990,4405638,2.17,4649442,4916548
서울특별시,2021,7,9558153,4409964,2.17,4645177,4912976
서울특별시,2021,8,9550227,4416816,2.16,4640740,4909487
서울특별시,2021,9,9542256,4421143,2.16,4636069,4906187
서울특별시,2021,10,9532428,4422587,2.16,4630630,4901798
서울특별시,2021,11,9520880,4424222,2.15,4624290,4896590
서울특별시,2021,12,9509458,4426007,2.15,4618040,4891418
서울특별시,2022,1,9505926,4430541,2.15,4615631,4890295
서울특별시,2022,2,9508451,4442586,2.14,4615823,4892628
서울특별시,2022,3,9506778,4451444,2.14,4613910,4892868
서울특별시,2022,4,9500480,4455106,2.13,4610082,4890398
서울특별시,2022,5,9496887,4460604,2.13,4607440,4889447
서울특별시,2022,6,9494807,4464840,2.13,4605655,4889152
서울특별시,2022,7,9493211,4469392,2.12,4604405,4888806
서울특별시,2022,8,9488454,4472975,2.12,4601295,4887159
서울특별시,2022,9,9450768,4450525,2.12,4582361,4868407
서울특별시,2022,10,9443722,4450389,2.12,4578459,4865263
서울특별시,2022,11,9436836,4448660,2.12,4574781,4862055
서울특별시,2022,12,9428372,4446296,2.12,4570048,4858324
서울특별시,2023,1,9424873,4447861,2.12,4567739,4857134
서울특별시,2023,2,9427583,4457982,2.11,4567957,4859626
서울특별시,2023,3,9426404,4463385,2.11,4566299,4860105
서울특별시,2023,4,9422710,4465391,2.11,4563512,4859198
서울특별시,2023,5,9418885,4467999,2.11,4560702,4858183
서울특별시,2023,6,9414093,4469158,2.11,4557609,4856484
서울특별시,2023,7,9411260,4471174,2.1,4555784,4855476
서울특별시,2023,8,9409466,4473734,2.1,4554020,4855446
서울특별시,2023,9,9407540,4475726,2.1,4552501,4855039
서울특별시,2023,10,9400249,4472603,2.1,4548150,4852099
서울특별시,2023,11,9390925,4469374,2.1,4543055,4847870
서울특별시,2023,12,9386034,4469417,2.1,4540031,4846003
서울특별시,2024,1,9384325,4471017,2.1,4538354,4845971
서울특별시,2024,2,9386705,4480607,2.09,4538306,4848399
서울특별시,2024,3,9384739,4485819,2.09,4536128,4848611
서울특별시,2024,4,9378269,4486137,2.09,4532115,4846154
서울특별시,2024,5,9371930,4486224,2.09,4528234,4843696
서울특별시,2024,6,9366283,4486014,2.09,4524862,4841421
서울특별시,2024,7,9360400,4486857,2.09,4521316,4839084
세종특별자치시,2020,1,342328,136056,2.52,170729,171599
세종특별자치시,2020,2,343788,136629,2.52,171403,172385
세종특별자치시,2020,3,344792,137208,2.51,171951,172841
세종특별자치시,2020,4,345216,137500,2.51,172176,173040
세종특별자치시,2020,5,345373,137893,2.5,172269,173104
세종특별자치시,2020,6,345341,138167,2.5,172234,173107
세종특별자치시,2020,7,346217,138720,2.5,172660,173557
세종특별자치시,2020,8,347232,139552,2.49,173183,174049
세종특별자치시,2020,9,348014,140222,2.48,173613,174401
세종특별자치시,2020,10,351007,141687,2.48,175135,175872
세종특별자치시,2020,11,353430,142912,2.47,176336,177094
세종특별자치시,2020,12,355831,144275,2.47,177568,178263
세종특별자치시,2021,1,357871,145403,2.46,178656,179215
세종특별자치시,2021,2,359569,146323,2.46,179528,180041
세종특별자치시,2021,3,360462,146763,2.46,180030,180432
세종특별자치시,2021,4,361396,147292,2.45,180462,180934
세종특별자치시,2021,5,362036,147848,2.45,180778,181258
세종특별자치시,2021,6,362995,148604,2.44,181328,181667
세종특별자치시,2021,7,364364,149580,2.44,181996,182368
세종특별자치시,2021,8,365309,150077,2.43,182430,182879
세종특별자치시,2021,9,366560,150841,2.43,183044,183516
세종특별자치시,2021,10,368276,151639,2.43,183879,184397
세종특별자치시,2021,11,369465,152301,2.43,184441,185024
세종특별자치시,2021,12,371895,153649,2.42,185678,186217
세종특별자치시,2022,1,374377,154890,2.42,186907,187470
세종특별자치시,2022,2,376399,155990,2.41,187858,188541
세종특별자치시,2022,3,377296,156696,2.41,188356,188940
세종특별자치시,2022,4,378196,157270,2.4,188778,189418
세종특별자치시,2022,5,379340,157846,2.4,189302,190038
세종특별자치시,2022,6,380215,158258,2.4,189723,190492
세종특별자치시,2022,7,380889,158495,2.4,190038,190851
세종특별자치시,2022,8,381439,158798,2.4,190276,191163
세종특별자치시,2022,9,381925,159036,2.4,190541,191384
세종특별자치시,2022,10,382258,159129,2.4,190683,191575
세종특별자치시,2022,11,382770,159150,2.41,190987,191783
세종특별자치시,2022,12,383591,159386,2.41,191389,192202
세종특별자치시,2023,1,384496,159556,2.41,191769,192727
세종특별자치시,2023,2,385285,160012,2.41,192110,193175
세종특별자치시,2023,3,385609,160320,2.41,192212,193397
세종특별자치시,2023,4,385825,160474,2.4,192316,193509
세종특별자치시,2023,5,386050,160604,2.4,192393,193657
세종특별자치시,2023,6,386126,160615,2.4,192435,193691
세종특별자치시,2023,7,386192,160562,2.41,192449,193743
세종특별자치시,2023,8,385953,160439,2.41,192271,193682
세종특별자치시,2023,9,385932,160479,2.4,192246,193686
세종특별자치시,2023,10,386079,160556,2.4,192299,193780
세종특별자치시,2023,11,386256,160764,2.4,192396,193860
세종특별자치시,2023,12,386525,160835,2.4,192524,194001
세종특별자치시,2024,1,386944,160942,2.4,192704,194240
세종특별자치시,2024,2,387193,161303,2.4,192836,194357
세종특별자치시,2024,3,387411,161711,2.4,192907,194504
세종특별자치시,2024,4,387726,161975,2.39,193099,194627
세종특별자치시,2024,5,387774,162063,2.39,193044,194730
세종특별자치시,2024,6,387940,162161,2.39,193149,194791
세종특별자치시,2024,7,388788,162554,2.39,193538,195250
울산광역시,2020,1,1147037,469007,2.45,589233,557804
울산광역시,2020,2,1145710,469551,2.44,588626,557084
울산광역시,2020,3,1144563,470294,2.43,588127,556436
울산광역시,2020,4,1144098,471153,2.43,587902,556196
울산광역시,2020,5,1143148,472255,2.42,587434,555714
울산광역시,2020,6,1142190,472983,2.41,586939,555251
울산광역시,2020,7,1141362,473640,2.41,586533,554829
울산광역시,2020,8,1140310,474328,2.4,585922,554388
울산광역시,2020,9,1139368,474970,2.4,585387,553981
울산광역시,2020,10,1138581,475424,2.39,584963,553618
울산광역시,2020,11,1137345,476112,2.39,584305,553040
울산광역시,2020,12,1136017,476893,2.38,583708,552309
울산광역시,2021,1,1135370,478531,2.37,583402,551968
울산광역시,2021,2,1132953,479441,2.36,582190,550763
울산광역시,2021,3,1129254,478528,2.36,580424,548830
울산광역시,2021,4,1128163,478865,2.36,579853,548310
울산광역시,2021,5,1127175,479362,2.35,579316,547859
울산광역시,2021,6,1126369,479971,2.35,578924,547445
울산광역시,2021,7,1125727,480623,2.34,578511,547216
울산광역시,2021,8,1124459,480951,2.34,577806,546653
울산광역시,2021,9,1123236,481483,2.33,577093,546143
울산광역시,2021,10,1122566,481811,2.33,576723,545843
울산광역시,2021,11,1122495,482287,2.33,576636,545859
울산광역시,2021,12,1121592,482650,2.32,576217,545375
울산광역시,2022,1,1121100,482917,2.32,575939,545161
울산광역시,2022,2,1119446,483490,2.32,575165,544281
울산광역시,2022,3,1118010,484122,2.31,574444,543566
울산광역시,2022,4,1117204,484641,2.31,573984,543220
울산광역시,2022,5,1116482,485349,2.3,573619,542863
울산광역시,2022,6,1115609,485652,2.3,573152,542457
울산광역시,2022,7,1114753,485759,2.29,572615,542138
울산광역시,2022,8,1113458,486060,2.29,571867,541591
울산광역시,2022,9,1112191,485838,2.29,571248,540943
울산광역시,2022,10,1111707,486070,2.29,570960,540747
울산광역시,2022,11,1111371,486101,2.29,570756,540615
울산광역시,2022,12,1110663,486143,2.28,570368,540295
울산광역시,2023,1,1110074,486281,2.28,570113,539961
울산광역시,2023,2,1108665,486823,2.28,569576,539089
울산광역시,2023,3,1107746,487241,2.27,569131,538615
울산광역시,2023,4,1107134,487447,2.27,568824,538310
울산광역시,2023,5,1106446,487873,2.27,568518,537928
울산광역시,2023,6,1106015,488421,2.26,568302,537713
울산광역시,2023,7,1105326,488828,2.26,567947,537379
울산광역시,2023,8,1104448,489064,2.26,567403,537045
울산광역시,2023,9,1104167,489298,2.26,567314,536853
울산광역시,2023,10,1104031,489851,2.25,567309,536722
울산광역시,2023,11,1103752,490174,2.25,567145,536607
울산광역시,2023,12,1103661,490690,2.25,567153,536508
울산광역시,2024,1,1103402,490987,2.25,567081,536321
울산광역시,2024,2,1102161,491670,2.24,566604,535557
울산광역시,2024,3,1101336,492279,2.24,566352,534984
울산광역시,2024,4,1101059,492911,2.23,566255,534804
울산광역시,2024,5,1100609,493411,2.23,566063,534546
울산광역시,2024,6,1100304,493783,2.23,565890,534414
울산광역시,2024,7,1099866,494078,2.23,565679,534187
인천광역시,2020,1,2956119,1239915,2.38,1481749,1474370
인천광역시,2020,2,2954955,1242107,2.38,1481133,1473822
인천광역시,2020,3,2952689,1243983,2.37,1479839,1472850
인천광역시,2020,4,2950972,1246255,2.37,1478916,1472056
인천광역시,2020,5,2950063,1249739,2.36,1478307,1471756
인천광역시,2020,6,2947217,1251818,2.35,1476813,1470404
인천광역시,2020,7,2945565,1253957,2.35,1475837,1469728
인천광역시,2020,8,2943491,1256383,2.34,1474620,1468871
인천광역시,2020,9,2942553,1259167,2.34,1474105,1468448
인천광역시,2020,10,2942233,1261590,2.33,1473834,1468399
인천광역시,2020,11,2942307,1264300,2.33,1473795,1468512
인천광역시,2020,12,2942828,1267956,2.32,1473943,1468885
인천광역시,2021,1,2942452,1270669,2.32,1473639,1468813
인천광역시,2021,2,2941705,1273377,2.31,1473245,1468460
인천광역시,2021,3,2936461,1272361,2.31,1470750,1465711
인천광역시,2021,4,2936214,1275194,2.3,1470490,1465724
인천광역시,2021,5,2936382,1277842,2.3,1470528,1465854
인천광역시,2021,6,2936367,1280291,2.29,1470544,1465823
인천광역시,2021,7,2937440,1283524,2.29,1470985,1466455
인천광역시,2021,8,2938429,1286458,2.28,1471347,1467082
인천광역시,2021,9,2941795,1290829,2.28,1472963,1468832
인천광역시,2021,10,2945009,1294158,2.28,1474536,1470473
인천광역시,2021,11,2946319,1296517,2.27,1475245,1471074
인천광역시,2021,12,2948375,1298647,2.27,1476373,1472002
인천광역시,2022,1,2949150,1300292,2.27,1476663,1472487
인천광역시,2022,2,2950978,1303227,2.26,1477432,1473546
인천광역시,2022,3,2952699,1306725,2.26,1478272,1474427
인천광역시,2022,4,2953260,1308777,2.26,1478514,1474746
인천광역시,2022,5,2955167,1311588,2.25,1479428,1475739
인천광역시,2022,6,2957066,1313975,2.25,1480432,1476634
인천광역시,2022,7,2960580,1317046,2.25,1482177,1478403
인천광역시,2022,8,2963117,1319683,2.25,1483370,1479747
인천광역시,2022,9,2960097,1318437,2.25,1481896,1478201
인천광역시,2022,10,2962388,1320238,2.24,1483026,1479362
인천광역시,2022,11,2964820,1321231,2.24,1484103,1480717
인천광역시,2022,12,2967314,1322632,2.24,1485175,1482139
인천광역시,2023,1,2969502,1324140,2.24,1486300,1483202
인천광역시,2023,2,2971788,1326947,2.24,1487333,1484455
인천광역시,2023,3,2974481,1330898,2.23,1488490,1485991
인천광역시,2023,4,2976338,1333148,2.23,1489277,1487061
인천광역시,2023,5,2978089,1335225,2.23,1490065,1488024
인천광역시,2023,6,2978749,1336603,2.23,1490345,1488404
인천광역시,2023,7,2981553,1339361,2.23,1491638,1489915
인천광역시,2023,8,2985152,1341807,2.22,1493440,1491712
인천광역시,2023,9,2987918,1344029,2.22,1494725,1493193
인천광역시,2023,10,2990276,1345719,2.22,1495744,1494532
인천광역시,2023,11,2993492,1347984,2.22,1497231,1496261
인천광역시,2023,12,2997410,1350912,2.22,1499016,1498394
인천광역시,2024,1,3000454,1352622,2.22,1500414,1500040
인천광역시,2024,2,3003150,1355494,2.22,1501543,1501607
인천광역시,2024,3,3006045,1359114,2.21,1502956,1503089
인천광역시,2024,4,3008484,1361550,2.21,1504078,1504406
인천광역시,2024,5,3009873,1363146,2.21,1504618,1505255
인천광역시,2024,6,3011073,1364650,2.21,1505177,1505896
인천광역시,2024,7,3012997,1366579,2.2,1505953,1507044
전라남도,2020,1,1864712,872739,2.14,935962,928750
전라남도,2020,2,1861894,873871,2.13,934900,926994
전라남도,2020,3,1859290,875423,2.12,933896,925394
전라남도,2020,4,1857083,877388,2.12,932970,924113
전라남도,2020,5,1855945,880440,2.11,932496,923449
전라남도,2020,6,1854618,882615,2.1,931898,922720
전라남도,2020,7,1853339,884043,2.1,931280,922059
전라남도,2020,8,1851985,885676,2.09,930466,921519
전라남도,2020,9,1851124,887358,2.09,930076,921048
전라남도,2020,10,1850680,888724,2.08,929911,920769
전라남도,2020,11,1850557,890570,2.08,929986,920571
전라남도,2020,12,1851549,893152,2.07,930615,920934
전라남도,2021,1,1850575,894611,2.07,930132,920443
전라남도,2021,2,1849795,896411,2.06,929889,919906
전라남도,2021,3,1844811,895024,2.06,927884,916927
전라남도,2021,4,1844148,896392,2.06,927667,916481
전라남도,2021,5,1842423,896634,2.05,927074,915349
전라남도,2021,6,1840921,897529,2.05,926398,914523
전라남도,2021,7,1839698,898434,2.05,925751,913947
전라남도,2021,8,1838353,899309,2.04,924912,913441
전라남도,2021,9,1835690,900110,2.04,923651,912039
전라남도,2021,10,1834653,901203,2.04,923037,911616
전라남도,2021,11,1833864,902193,2.03,922677,911187
전라남도,2021,12,1832803,903108,2.03,922221,910582
전라남도,2022,1,1832604,903758,2.03,922190,910414
전라남도,2022,2,1831451,905202,2.02,921753,909698
전라남도,2022,3,1829501,905818,2.02,920971,908530
전라남도,2022,4,1828550,906664,2.02,920492,908058
전라남도,2022,5,1827674,907606,2.01,920050,907624
전라남도,2022,6,1826440,907953,2.01,919417,907023
전라남도,2022,7,1825534,908240,2.01,918956,906578
전라남도,2022,8,1824104,908581,2.01,918260,905844
전라남도,2022,9,1820458,907276,2.01,916611,903847
전라남도,2022,10,1819157,907462,2.0,915996,903161
전라남도,2022,11,1818484,907615,2.0,915677,902807
전라남도,2022,12,1817697,907710,2.0,915272,902425
전라남도,2023,1,1816707,907970,2.0,914811,901896
전라남도,2023,2,1814858,908722,2.0,914087,900771
전라남도,2023,3,1813872,909958,1.99,913670,900202
전라남도,2023,4,1813439,910897,1.99,913624,899815
전라남도,2023,5,1812475,911779,1.99,913215,899260
전라남도,2023,6,1811554,912202,1.99,912823,898731
전라남도,2023,7,1810071,912278,1.98,912075,897996
전라남도,2023,8,1808339,912139,1.98,911340,896999
전라남도,2023,9,1807295,912090,1.98,910810,896485
전라남도,2023,10,1805823,911474,1.98,910179,895644
전라남도,2023,11,1804875,911302,1.98,909744,895131
전라남도,2023,12,1804217,911442,1.98,909548,894669
전라남도,2024,1,1802672,911238,1.98,908705,893967
전라남도,2024,2,1800352,911453,1.98,907780,892572
전라남도,2024,3,1798435,911977,1.97,906995,891440
전라남도,2024,4,1797199,912121,1.97,906512,890687
전라남도,2024,5,1795717,912315,1.97,905860,889857
전라남도,2024,6,1794967,912551,1.97,905462,889505
전라남도,2024,7,1793747,912659,1.97,904835,888912
전라북도,2020,1,1817302,817017,2.22,903385,913917
전라북도,2020,2,1815112,818452,2.22,902365,912747
전라북도,2020,3,1812936,820140,2.21,901252,911684
전라북도,2020,4,1811619,821517,2.21,900628,910991
전라북도,2020,5,1810097,824032,2.2,899894,910203
전라북도,2020,6,1808802,826134,2.19,899137,909665
전라북도,2020,7,1808044,827895,2.18,898719,909325
전라북도,2020,8,1807094,829789,2.18,898296,908798
전라북도,2020,9,1806441,831694,2.17,898048,908393
전라북도,2020,10,1805937,833069,2.17,897770,908167
전라북도,2020,11,1805204,834858,2.16,897393,907811
전라북도,2020,12,1804104,836660,2.16,896874,907230
전라북도,2021,1,1802748,838242,2.15,896115,906633
전라북도,2021,2,1801319,840063,2.14,895485,905834
전라북도,2021,3,1797450,839942,2.14,893974,903476
전라북도,2021,4,1796331,841378,2.13,893415,902916
전라북도,2021,5,1794682,841543,2.13,892833,901849
전라북도,2021,6,1794345,842662,2.13,892670,901675
전라북도,2021,7,1793902,843708,2.13,892487,901415
전라북도,2021,8,1792476,844645,2.12,891776,900700
전라북도,2021,9,1791110,846204,2.12,891073,900037
전라북도,2021,10,1789770,847406,2.11,890378,899392
전라북도,2021,11,1788616,848380,2.11,889824,898792
전라북도,2021,12,1786855,849001,2.1,888994,897861
전라북도,2022,1,1785392,849366,2.1,888291,897101
전라북도,2022,2,1783923,850567,2.1,887611,896312
전라북도,2022,3,1782205,851558,2.09,886928,895277
전라북도,2022,4,1780824,852086,2.09,886274,894550
전라북도,2022,5,1779230,852829,2.09,885475,893755
전라북도,2022,6,1778279,853717,2.08,884908,893371
전라북도,2022,7,1776949,854552,2.08,884164,892785
전라북도,2022,8,1775664,855440,2.08,883436,892228
전라북도,2022,9,1772596,854565,2.07,882044,890552
전라북도,2022,10,1771776,855270,2.07,881608,890168
전라북도,2022,11,1770839,855573,2.07,881151,889688
전라북도,2022,12,1769607,855849,2.07,880592,889015
전라북도,2023,1,1768229,856232,2.07,879922,888307
전라북도,2023,2,1766524,857504,2.06,879065,887459
전라북도,2023,3,1765175,858935,2.06,878456,886719
전라북도,2023,4,1764181,859599,2.05,877966,886215
전라북도,2023,5,1763004,860284,2.05,877382,885622
전라북도,2023,6,1762021,860761,2.05,876978,885043
전라북도,2023,7,1761169,861288,2.04,876459,884710
전라북도,2023,8,1759815,861561,2.04,875839,883976
전라북도,2023,9,1758661,861647,2.04,875353,883308
전라북도,2023,10,1757295,861451,2.04,874659,882636
전라북도,2023,11,1756183,861263,2.04,874078,882105
전라북도,2023,12,1754757,861193,2.04,873419,881338
전라북도,2024,1,1752921,861029,2.04,872493,880428
전라북도,2024,2,1751318,861966,2.03,871830,879488
전라북도,2024,3,1749376,863028,2.03,870857,878519
전라북도,2024,4,1748047,863318,2.02,870133,877914
전라북도,2024,5,1746912,863874,2.02,869631,877281
전라북도,2024,6,1745885,864100,2.02,869197,876688
전라북도,2024,7,1744661,864113,2.02,868718,875943
제주특별자치도,2020,1,670749,293362,2.29,337231,333518
제주특별자치도,2020,2,670876,293932,2.28,337295,333581
제주특별자치도,2020,3,670508,294297,2.28,337055,333453
제주특별자치도,2020,4,670595,295387,2.27,337119,333476
제주특별자치도,2020,5,670793,296803,2.26,337111,333682
제주특별자치도,2020,6,671316,297669,2.26,337343,333973
제주특별자치도,2020,7,671913,298347,2.25,337587,334326
제주특별자치도,2020,8,672524,299051,2.25,337822,334702
제주특별자치도,2020,9,672948,299807,2.24,337932,335016
제주특별자치도,2020,10,673606,300540,2.24,338190,335416
제주특별자치도,2020,11,674001,301100,2.24,338312,335689
제주특별자치도,2020,12,674635,302033,2.23,338609,336026
제주특별자치도,2021,1,674615,302473,2.23,338553,336062
제주특별자치도,2021,2,675137,303203,2.23,338673,336464
제주특별자치도,2021,3,673974,302580,2.23,338206,335768
제주특별자치도,2021,4,674484,303191,2.22,338422,336062
제주특별자치도,2021,5,674877,303845,2.22,338566,336311
제주특별자치도,2021,6,675293,304353,2.22,338766,336527
제주특별자치도,2021,7,675876,305044,2.22,338978,336898
제주특별자치도,2021,8,675883,305517,2.21,338962,336921
제주특별자치도,2021,9,676079,306252,2.21,338975,337104
제주특별자치도,2021,10,676569,306741,2.21,339195,337374
제주특별자치도,2021,11,676768,307266,2.2,339256,337512
제주특별자치도,2021,12,676759,307529,2.2,339177,337582
제주특별자치도,2022,1,676691,307819,2.2,339071,337620
제주특별자치도,2022,2,677143,308530,2.19,339248,337895
제주특별자치도,2022,3,677218,308988,2.19,339320,337898
제주특별자치도,2022,4,677413,309322,2.19,339383,338030
제주특별자치도,2022,5,677766,309822,2.19,339578,338188
제주특별자치도,2022,6,678012,310265,2.19,339697,338315
제주특별자치도,2022,7,678491,310747,2.18,339951,338540
제주특별자치도,2022,8,679016,311272,2.18,340105,338911
제주특별자치도,2022,9,678426,311115,2.18,339801,338625
제주특별자치도,2022,10,678324,311251,2.18,339731,338593
제주특별자치도,2022,11,678373,311303,2.18,339758,338615
제주특별자치도,2022,12,678159,311355,2.18,339590,338569
제주특별자치도,2023,1,677493,311360,2.18,339325,338168
제주특별자치도,2023,2,677090,311801,2.17,339078,338012
제주특별자치도,2023,3,677031,312326,2.17,339056,337975
제주특별자치도,2023,4,677115,312612,2.17,339086,338029
제주특별자치도,2023,5,677057,312869,2.16,338995,338062
제주특별자치도,2023,6,676832,312910,2.16,338857,337975
제주특별자치도,2023,7,676810,313030,2.16,338843,337967
제주특별자치도,2023,8,676489,313081,2.16,338622,337867
제주특별자치도,2023,9,676317,313265,2.16,338514,337803
제주특별자치도,2023,10,676119,313291,2.16,338391,337728
제주특별자치도,2023,11,675845,313269,2.16,338265,337580
제주특별자치도,2023,12,675252,313155,2.16,337976,337276
제주특별자치도,2024,1,674353,313050,2.15,337578,336775
제주특별자치도,2024,2,673665,313304,2.15,337202,336463
제주특별자치도,2024,3,673103,313626,2.15,336826,336277
제주특별자치도,2024,4,672775,313797,2.14,336674,336101
제주특별자치도,2024,5,672563,314094,2.14,336588,335975
제주특별자치도,2024,6,672252,314321,2.14,336481,335771
제주특별자치도,2024,7,672068,314519,2.14,336330,335738
충청남도,2020,1,2122455,960438,2.21,1081552,1040903
충청남도,2020,2,2120995,961890,2.21,1081153,1039842
충청남도,2020,3,2119749,963547,2.2,1080705,1039044
충청남도,2020,4,2118457,964860,2.2,1080256,1038201
충청남도,2020,5,2118510,967947,2.19,1080425,1038085
충청남도,2020,6,2119771,971033,2.18,1081224,1038547
충청남도,2020,7,2120692,973444,2.18,1081752,1038940
충청남도,2020,8,2120519,975474,2.17,1081807,1038712
충청남도,2020,9,2120559,977399,2.17,1082029,1038530
충청남도,2020,10,2120347,978784,2.17,1081967,1038380
충청남도,2020,11,2120607,980711,2.16,1082311,1038296
충청남도,2020,12,2121029,983153,2.16,1082634,1038395
충청남도,2021,1,2119837,984768,2.15,1082095,1037742
충청남도,2021,2,2119542,987100,2.15,1082026,1037516
충청남도,2021,3,2115823,985844,2.15,1080841,1034982
충청남도,2021,4,2116452,987866,2.14,1081275,1035177
충청남도,2021,5,2117260,989963,2.14,1081854,1035406
충청남도,2021,6,2117400,991636,2.14,1082113,1035287
충청남도,2021,7,2118205,993794,2.13,1082654,1035551
충청남도,2021,8,2118183,995603,2.13,1082664,1035519
충청남도,2021,9,2118098,997516,2.12,1082596,1035502
충청남도,2021,10,2118977,999286,2.12,1083133,1035844
충청남도,2021,11,2119529,1000660,2.12,1083419,1036110
충청남도,2021,12,2119257,1001915,2.12,1083366,1035891
충청남도,2022,1,2118638,1003132,2.11,1083242,1035396
충청남도,2022,2,2118912,1005290,2.11,1083507,1035405
충청남도,2022,3,2119099,1007776,2.1,1083753,1035346
충청남도,2022,4,2119296,1009254,2.1,1083970,1035326
충청남도,2022,5,2119661,1010866,2.1,1084296,1035365
충청남도,2022,6,2120201,1012446,2.09,1084712,1035489
충청남도,2022,7,2121011,1013955,2.09,1085037,1035974
충청남도,2022,8,2121082,1015515,2.09,1085209,1035873
충청남도,2022,9,2120269,1015797,2.09,1084756,1035513
충청남도,2022,10,2121333,1017146,2.09,1085425,1035908
충청남도,2022,11,2122357,1018101,2.08,1086076,1036281
충청남도,2022,12,2123037,1019093,2.08,1086632,1036405
충청남도,2023,1,2122913,1020071,2.08,1086686,1036227
충청남도,2023,2,2123625,1022584,2.08,1087162,1036463
충청남도,2023,3,2124650,1025100,2.07,1087705,1036945
충청남도,2023,4,2125333,1026355,2.07,1088126,1037207
충청남도,2023,5,2125833,1027858,2.07,1088548,1037285
충청남도,2023,6,2126374,1029072,2.07,1088924,1037450
충청남도,2023,7,2126640,1030071,2.06,1089245,1037395
충청남도,2023,8,2127077,1031232,2.06,1089549,1037528
충청남도,2023,9,2127630,1032336,2.06,1089884,1037746
충청남도,2023,10,2128563,1033330,2.06,1090461,1038102
충청남도,2023,11,2129591,1034508,2.06,1091095,1038496
충청남도,2023,12,2130119,1035449,2.06,1091570,1038549
충청남도,2024,1,2130509,1036685,2.06,1092059,1038450
충청남도,2024,2,2131309,1039375,2.05,1092711,1038598
충청남도,2024,3,2132745,1042712,2.05,1093684,1039061
충청남도,2024,4,2133828,1044592,2.04,1094336,1039492
충청남도,2024,5,2134618,1046334,2.04,1094837,1039781
충청남도,2024,6,2134817,1047238,2.04,1094922,1039895
충청남도,2024,7,2135171,1048152,2.04,1095237,1039934
충청북도,2020,1,1599391,722726,2.21,810129,789262
충청북도,2020,2,1598599,723931,2.21,809805,788794
충청북도,2020,3,1597639,725289,2.2,809369,788270
충청북도,2020,4,1596613,726381,2.2,809005,787608
충청북도,2020,5,1596710,729270,2.19,809114,787596
충청북도,2020,6,1597593,732285,2.18,809657,787936
충청북도,2020,7,1597936,734112,2.18,809841,788095
충청북도,2020,8,1598162,736095,2.17,810023,788139
충청북도,2020,9,1598536,738094,2.17,810302,788234
충청북도,2020,10,1599102,739808,2.16,810528,788574
충청북도,2020,11,1599680,742087,2.16,810903,788777
충청북도,2020,12,1600837,745644,2.15,811591,789246
충청북도,2021,1,1599658,746441,2.14,811057,788601
충청북도,2021,2,1599122,747979,2.14,810751,788371
충청북도,2021,3,1595714,747313,2.14,809457,786257
충청북도,2021,4,1596303,748975,2.13,809679,786624
충청북도,2021,5,1596955,750635,2.13,809946,787009
충청북도,2021,6,1597503,752237,2.12,810225,787278
충청북도,2021,7,1597501,753893,2.12,810258,787243
충청북도,2021,8,1597179,755059,2.12,810095,787084
충청북도,2021,9,1596765,756520,2.11,809981,786784
충청북도,2021,10,1596948,757980,2.11,810093,786855
충청북도,2021,11,1597019,759106,2.1,810261,786758
충청북도,2021,12,1597427,760672,2.1,810672,786755
충청북도,2022,1,1597097,761737,2.1,810548,786549
충청북도,2022,2,1597022,763610,2.09,810649,786373
충청북도,2022,3,1597484,766005,2.09,811004,786480
충청북도,2022,4,1597284,767041,2.08,811063,786221
충청북도,2022,5,1597033,768171,2.08,811009,786024
충청북도,2022,6,1597118,769180,2.08,811127,785991
충청북도,2022,7,1597163,770205,2.07,811286,785877
충청북도,2022,8,1596886,771190,2.07,811289,785597
충청북도,2022,9,1595624,770996,2.07,810741,784883
충청북도,2022,10,1595578,771479,2.07,810747,784831
충청북도,2022,11,1595284,771562,2.07,810731,784553
충청북도,2022,12,1595058,771848,2.07,810782,784276
충청북도,2023,1,1594459,772155,2.06,810740,783719
충청북도,2023,2,1593434,773184,2.06,810305,783129
충청북도,2023,3,1594056,775386,2.06,810811,783245
충청북도,2023,4,1594109,776038,2.05,810806,783303
충청북도,2023,5,1594007,776795,2.05,810783,783224
충청북도,2023,6,1593931,777614,2.05,810748,783183
충청북도,2023,7,1594240,778481,2.05,810943,783297
충청북도,2023,8,1594337,779442,2.05,810927,783410
충청북도,2023,9,1594326,779770,2.04,810835,783491
충청북도,2023,10,1594211,779850,2.04,810820,783391
충청북도,2023,11,1594038,779978,2.04,810734,783304
충청북도,2023,12,1593469,779967,2.04,810448,783021
충청북도,2024,1,1592155,779404,2.04,809830,782325
충청북도,2024,2,1590947,779904,2.04,809319,781628
충청북도,2024,3,1591044,782031,2.03,809472,781572
충청북도,2024,4,1590854,782921,2.03,809485,781369
충청북도,2024,5,1591201,784163,2.03,809694,781507
충청북도,2024,6,1591485,785163,2.03,809921,781564
충청북도,2024,7,1591182,785504,2.03,809799,781383
